Wo, Wo, Wo, Wo, Wwr, Ww, Ds, Gg^Efm, Gg^Fds, Gs^Fds, Ds, Wwf, Wwf, Gg, Gd^Es, Hh^Fds, Hh^Fds, Hh, Mm, Mm^Xm, Mm^Xm, Hh, Mm, Mm^Xm, Mm^Xm, Hh, Mm, Mm^Xm, Mm, Gs^Fds, Re^Fds, Ds, Ds, Ww, Sm, Ss, Ss, Ss
Wo, Wo, Ww, Wwr, Ds^Es, Wwf, Ds, Gg^Efm, Wwf, Gs^Fds, Ww, Ds, Wwf^Ewl, Ss, Gs^Es, Gg^Fds, Hh^Es, Mm, Mm, Mm, Mm, Mm^Xm, Mm, Mm, Mm, Mm^Xm, Mm, Mm, Gs^Fms, Gd^Fms, Ww, Ww, Ss^Em, Sm, Ss, Ss^Tf, Ss^Emf, Ss^Emf
Ww, Ww, Wwf, Ds^Edb, Cer^Edb, Ds^Es, Gd^Edb, Gg^Fms, Gg^Es, Gs^Fds, Ds^Es, Ds^Es, Wwf^Ewl, Gg^Edb, Mm, Mm^Xm, Mm^Xm, Hh^Fms, Hh^Fms, Mm, Mm^Xm, Mm, Hh, Hh^Fds, Mm^Xm, Mm, Gs^Fms, Gg, Wwf, Ww, Ss^Emf, Ss^Vhs, Ss^Em, Ss, Ww, Ss^Em, Ss^Em, Ss^Em
Ds, Wwr, Ds^Es, Cer, 1 Ker, Cer^Edb, Gd^Es, Gg^Efm, Gg^Fms, Ww, Ss^Em, Wwf^Ewf, Ww^Ewf, Gs^Edb, Hh^Fds, Mm, Mm, Mm^Xm, Mm, Mm, Mm, Mm^Xm, Mm^Xm, Mm, Mm, Mm^Xm, Mm^Xm, Re^Es, Re^Es, Wwf^Ewl, Sm, Sm, Ss, Chw, Chw^Ewf, Ww, Ss^Dr, Ss
Re, Ds^Es, Re^Edb, Cer^Edb, Cer, Cer, Gd^Es, Gg, Ds, Ss, Sm^Em, Sm^Em, Ww, Gs^Fms, Mm, Mm^Xm, Mm^Xm, Mm, Mm, Hh, Hh^Fms, Mm, Mm, Mm, Gg^Fms, Mm, Mm, Mm, Re, Wwf^Ewf, Wwr, Ss, Chw, 3 Khw, Chw^Ewl, Ss, Ss^Tf, Ss^Emf
Gg^Efm, Re, Gs^Vht, Re^Edb, Gd^Edb, Gd^Es, Gll^Edb, Re, Ww, Ds, Ss^Emf, Ss^Tf, Gg, Gg, Hh, Mm, Mm, Mm^Xm, Mm, Mm, Mm, Hh^Fds, Hh^Emf, Gs^Fms, Ds, Gg^Fds, Gg^Fds, Gg, Ww, Wwf, Wwr, Chw, Gg^Fms, Chw^Ewl, Gg, Wwf, Wwf, Wwf
Gg^Fds, Gg^Efm, Gg, Gll, Gs^Efm, Gll^Edb, Gg^Edb, Re, Re^Edb, Wwf^Ewl, Ss^Em, Ww, Gs^Em, Hh^Fds, Mm^Xm, Mm^Xm, Mm, Mm, Mm^Xm, Mm^Xm, Mm, Hh^Em, Hh^Fds, Gd^Em, Re, Wwf, Wwf^Ewf, Ww, Sm^Dr, Wwr, Ss^Tf, Ss^Emf, Ds, Gg, Gd^Fms, Ds, Ds, Ds
Gs^Fds, Gg^Fms, Gg^Fms, Gg^Efm, Gg^Vht, Gg, Gg^Fms, Gd^Edb, Re^Edb, Ww^Ewl, Ww^Ewf, Gd^Emf, Mm, Mm^Xm, Mm, Mm, Mm, Mm^Xm, Mm, Mm, Mm, Mm, Re^Es, Re, Wwf, Sm^Ewf, Wwf^Ewf, Ww^Ewl, Sm^Ewf, Sm, Ss^Em, Ww, Ds^Es, Gd, Gs, Gs^Fds, Gg^Efm, Gg
Ds, Wwf, Gg^Em, Gg, Gg, Gg, Gg, Gg^Efm, Ds, Ww^Ewl, Wwf^Em, Gll^Em, Gd^Emf, Mm, Gg^Efm, Re, Hh^Fds, Mm, Re, Mm, Gg, Gs, Re^Es, Wwf^Es, Wwr, Sm, Ss^Tf, Sm, Ss, Ds^Es, Ds, Ds^Es, Gs^Fms, Gll, Mm, Hh, Hh^Fds, Gg^Efm
Ds, Gs^Fds, Gd^Em, Gd^Emf, Gd^Em, Gll^Efm, Wwf, Gg^Fds, Ds, Ss^Em, Sm^Vhs, Wwf, Wwf^Ewl, Gg^Em, Ww, Re, Re, Hh, Re, Gg^Fms, Gg^Fds, Re, Wwf, Sm^Ewl, Sm^Ewf, Ss^Emf, Chs, Ss, Re, Re^Es, Gg^Efm, Gs, Re, Re, Hh^Em, Mm, Mm, Hh^Fms
Wwf, Ds, Ds, Gs^Em, Gs^Edb, Gll, Wwf^Ewl, Wwf, Re, Ww, Sm^Ewf, Sm^Ewl, Ss, Ss^Emf, Gd^Es, Gs^Es, Gg^Fds, Re, Gs^Fms, Gg^Fet, Gs, Ds, Wwf, Sm^Dr, Ss^Em, Ss^Em, Ss, Ss^Tf, Re^Es, Gg^Efm, Gs, Gs^Fms, Hh^Fds, Hh^Fds, Mm^Xm, Hh^Emf, Hh^Fms, Hh^Fms
Ss, Wwf^Ewl, Wwf^Ewl, Ds, Gs^Es, Gd^Fms, Gg, Gg^Fds, Gg^Fms, Re, Wwf, Ww, Ww, Ds^Es, Gs^Vhr, Gll, Gg^Efm, Gs^Fms, Gs^Efm, Gd^Fms, Gs^Es, Ds^Es, Ds, Ww^Ewl, Ds, Ds^Es, Re, Re, Gd^Edb, Gg^Em, Re, Hh^Fms, Mm^Xm, Mm^Xm, Mm, Mm, Mm^Xm, Hh^Fds
Ss, Ss^Emf, Wwf^Ewl, Ds^Es, Re, Gll^Es, Re, Gg^Efm, Gg^Efm, Re, Gg, Ds^Es, Ds, Ds^Es, Gs^Emf, Gd, Gg^Efm, Gg^Efm, Wwf, Gll, Gll^Es, Gs^Es, Gs^Edb, Ds, Wwf^Es, Gg^Fds, Wwf^Ewl, Wwf, Gll, Gd^Edb, Re, Mm, Mm, Mm, Mm^Xm, Mm, Mm, Mm
Sm, Sm^Ewl, Wwf^Ewf, Ds^Es, Ss^Emf, Re, Ss, Re^Efm, Re, Gs^Vhr, Ds, Gg^Efm, Re^Edb, Gd^Edb, Gll, Wwf^Ewf, Gg^Fds, Gg^Edb, Re^Edb, Gs^Edb, Gs^Fms, Gs^Fms, Gg^Edb, Gll^Edb, Gg^Efm, Wwf^Ewf, Gs^Fds, Gs^Fms, Gll, Chr^Fms, Gg^Efm, Re, Re, Mm, Mm, Mm^Xm, Mm^Xm, Hh^Fds
Ss, Sm, Ss^Emf, Wwf, Wwr, Ss^Em, Sm, Ww^Dr, Ds^Es, Ds^Es, Wwf^Ewl, Ds, Ds^Es, Re^Edb, Wwf, Wwf, Gg, Re, Ww, Re, Gg^Fms, Gg^Fds, Hh, Gg^Efm, Gg^Fds, Gs, Gd^Vhc, Gd^Emf, Chr^Emf, Chr^Ebn, Gg, Wwf, Gs^Fds, Gs, Gs, Mm, Mm, Mm
Ss^Em, Ss^Tf, Wwf, Wwf, Wwr, Sm, Sm, Ss^Em, Wwf, Wwf^Ewl, Chs, Wwf, Ds, Ww, Ss^Emf, Gs, Ww^Ewl, Wwr, Ww^Ewf, Re^Fms, Mm, Mm^Xm, Mm, Hh, Mm^Xm, Gs, Gs^Efm, Gd^Em, Re^Edb, Re, Re^Vhcr, Wwf^Ewf, Wwf^Ewl, Chr^Fds, Chr^Fms, Gg^Fds, Gd, Hh^Fds
Ss, Ss^Emf, Ss^Em, Sm, Ww^Ewf, Wwr, Ss^Emf, Ss^Em, Ss^Em, Sm^Em, Sm, Wwr, Wwr, Ss, Sm^Em, Ss^Em, Gd, Ww^Ewl, Gd^Em, Gs^Fds, Mm, Mm, Mm^Xm, Mm^Xm, Mm, Mm, Hh^Fds, Gg^Edb, Re^Edb, Hh^Edb, Mm^Xm, Gs^Edb, Gd^Edb, Chr^Ebn, Chr^Emf, Chr^Fms, Wwf^Ewf, Gs^Fds
Sm, Sm^Em, Sm, Sm, Ww^Ewf, Ss^Tf, Sm, Ss^Vhs, Ss^Em, Sm, Ss, Ss^Emf, Ss^Emf, Wwr, Ww, Ss, Wwf, Gs^Fds, Mm, Mm, Mm^Xm, Mm, Mm, Mm, Mm, Mm^Xm, Mm, Hh^Fms, Re^Em, Mm, Mm, Mm, Mm, Gd^Edb, Chr^Ebn, 4 Khr, Chr, Wwf^Ewl
Sm, Sm^Dr, Chs, Sm^Ewf, Sm, Ww^Ewl, Ww, Ww^Dr, Ww^Ewl, Ww^Ewl, Ds^Es, Ss^Em, Ww, Re, Gs^Efm, Gg^Es, Gg^Fms, Hh^Fds, Hh^Emf, Mm, Mm, Mm^Xm, Mm^Xm, Hh^Fds, Hh, Mm, Hh^Fds, Hh^Em, Gs^Emf, Hh^Emf, Mm, Mm, Mm, Gg^Edb, Gs^Es, Chr, Gd^Fms, Wwf
Ss, Ss^Em, Chs^Em, 2 Khs, Chs, Sm, Sm, Sm, Ss^Emf, Ds, Wwf, Ds, Re^Em, Re^Em, Mm^Xm, Mm^Xm, Mm, Hh^Em, Mm, Mm^Xm, Mm^Xm, Mm, Mm, Mm, Mm, Mm, Hh, Hh^Fds, Gll^Em, Hh^Em, Mm, Mm, Mm^Xm, Hh, Gll^Es, Gs^Vhcr, Gs^Fds, Gs^Fds
Ss, Ss^Emf, Ss^Tf, Chs^Em, Wwf^Ewf, Chs, Wwf, Ss, Ds, Wwf, Gg^Fms, Gs^Fms, Mm, Mm^Xm, Mm, Mm, Mm, Hh^Fds, Mm^Xm, Mm, Mm, Mm^Xm, Mm, Mm, Mm, Hh^Fds, Mm^Xm, Hh, Gd, Hh^Fms, Hh^Fms, Mm, Mm, Mm, Gd^Fds, Gll^Es, Gg^Efm, Gg^Efm
Ss, Ss^Emf, Ss, Wwf^Ewl, Wwf, Wwf, Ss^Emf, Ss^Emf, Ds, Gg, Hh, Hh^Fds, Hh, Mm, Mm, Mm, Hh, Mm, Mm, Mm, Hh, Mm, Mm, Mm, Hh, Mm, Mm, Mm, Gg^Fds, Gs^Fds, Gs^Fms, Hh, Gg^Fds, Gs, Gs, Gs, Gg, Gg^Efm
